################################
#---#---#---#---#---#---#---#--#
#---------------------------#--#
#---#---#---#---#---#---#---#--#
######-###-###############-###-#
#---#---#---#---#---#---#---#--#
#-------#---#-----------#------#
#---#---#---#---#---#---#---#--#
##-###############-###########-#
#---#---#---#---#---#---#---#--#
#---#-------#-H-#-------#---#--#
#---#---#---#---#---#---#---#--#
##-###-###-###-###-#######-###-#
#---#---#---#---#---#---#---#--#
#---#---#----- ---------#------#
#---#---#---#---#---#---#---#--#
##-#######-###-###-###-###-#####
#---#---#---#---#---#---#---#--#
#---#-------#---#---#---#---#--#
#---#---#---#---#---#---#---#--#
##-###########-###-#######-###-#
#---#---#---#---#---#---#---#--#
#-----------#---#---#-------#--#
#---#---#---#---#---#---#---#--#
##-###-###-#######-###-#######-#
#---#---#---#---#---#---#---#--#
#---#---#---#-----------#------#
#---#---#---#---#---#---#---#--#
##-###-###################-###-#
#---#---#---#---#---#---#---#--#
#---#-----------------------#-o#
################################

,,,,,,,,,
.........