  ##### #####
  #   ###   #
  # k #o# k #
#####g#h#g#####
# Y b     r Y #
# k #B H R# k #
#####k   k#####
# k #B   R# k #
#   r     b   #
######y#y######
    #  #  #
    # k#k # 
    #  #G #
    #######
    ,,.