
    ##############
    #v<<<<<<<<<<<#
 ####v##########^#
 #>k>v<k<<<<<<<#^#
 #^##t########^#^#
 #^#    #  - f^#^#
 #^#    #W # f^#^#
 #^#    #  # f^#^#
 #^#       # f^#^#
 #^#### # ######^#
 #^w #  #  ###>>^#
 #^w #  #  ho#^###
 #^w # F#t####^#
 #^w -  #   k ^#
 ###############




...
 ,