
#############
#k         k#
# k       k #
#  k     k  #
#   k   k   #
#    k k    #
#     k     #
#    k k    #
#   k   k   #
#  k     k  #
# k       k #
#k         k#
#           #
###########h#
#           #
#o          #
#           #
#############