##################
#Wh             k#
###   k      k   #
  #       k      #
  # k            #
  #             k#
  #     ##########
  #   k          #
  #              #
  #wwwww#######  #
  #wwwww      #k #
  #wwwww     o#  #
  #wwwww      #  #
  #############  #
      #          #
      #    k  k  #
      #          #
      ############










,,,,
..........