       ###
       #o#
   #####h####
   #v<<<<<<<#
   #v######^#
####v#wwww#^####
#v<<<#wFkw#^<<<#
#v####wwww####^#
#v####    fff#^#
#v####  H fVf#^#
#v####  W fkf#^#
#v####    fff#^#
#v####    ####^#
#>>>>>^^^>>>>>^#
######^k^^######
     #^^^^#
     ######


,,......