###############
#       O     #
#             #
#v<<<      O  #
#v  ^   >>>>>v#
#v  ^ d       #
#>>>^      D  #
o       i QQ
w m m m m QQ
W         QQ
k
h
R
B
G
Y
r
b
g
y
m
t
f
F
v
<
^
-
V
########
#-------
#-------
#-------
#-------
########